30
35
0 0 0 0 0 0 0 0 0 0 0 0 0 0 0 0 0 0 0 0 0 0 0 0 0 0 0 0 0 0  
0 0 0 0 0 0 0 0 0 0 0 0 0 0 0 0 0 0 0 0 0 0 0 0 0 0 0 0 0 0 
0 0 0 0 0 0 0 0 0 0 0 0 0 0 0 0 0 0 0 0 0 0 0 0 0 0 0 0 0 0  
0 0 0 0 0 0 0 0 0 6 4 4 4 0 0 0 0 0 0 0 0 0 0 0 0 0 0 0 0 0  
0 0 0 0 0 0 0 0 5 2 3 3 2 5 0 0 0 4 4 0 0 0 0 0 0 0 0 0 0 0  
0 0 0 0 0 0 0 5 2 3 3 3 3 1 4 4 4 1 1 1 0 0 0 0 0 0 0 0 0 0  
0 0 0 0 0 0 5 2 3 2 2 2 1 1 1 2 1 1 1 1 1 0 0 0 0 0 0 0 0 0   
0 0 0 0 0 5 2 1 1 2 2 1 1 1 1 2 2 2 2 1 1 1 0 0 0 1 0 0 0 0   
0 0 0 0 5 2 1 1 1 2 2 1 1 1 1 1 1 1 2 1 1 1 1 0 1 1 0 0 0 0   
0 0 0 5 2 1 2 2 2 2 1 2 2 2 1 2 1 1 2 1 1 1 1 1 1 1 0 0 0 0   
0 0 5 2 1 2 2 2 2 2 2 2 2 2 1 1 2 1 2 1 1 1 1 1 1 0 0 0 0 0   
0 0 1 2 1 1 2 2 2 2 2 2 2 1 1 1 2 2 1 2 1 1 1 1 0 0 0 0 0 0   
0 0 1 1 1 1 1 1 1 1 1 1 2 2 1 1 2 1 1 2 1 1 1 1 0 0 0 0 0 0   
0 0 1 1 1 1 1 1 1 1 1 1 2 2 1 1 1 1 1 2 1 1 1 1 0 0 0 0 0 0   
0 0 0 1 1 1 1 1 1 1 1 1 2 1 2 2 1 1 1 2 1 1 1 0 0 0 0 0 0 0   
0 0 0 0 1 1 1 1 1 1 1 1 1 1 1 1 1 1 1 2 1 1 1 0 0 0 0 0 0 0   
0 0 0 0 0 1 1 1 1 1 1 1 1 1 1 1 1 1 1 2 1 1 1 0 0 0 0 0 0 0   
0 0 0 0 0 0 0 0 1 1 1 0 1 1 1 1 1 1 2 1 1 1 0 0 0 0 0 0 0 0   
0 0 0 0 0 0 0 0 0 0 0 0 1 1 1 1 1 1 1 2 1 1 0 0 0 0 0 0 0 0   
0 0 0 0 0 0 0 0 0 0 0 0 1 1 1 1 1 1 2 1 1 1 0 0 0 0 0 0 0 0   
0 0 0 0 0 0 0 0 0 0 0 0 1 1 1 1 1 2 1 1 1 1 1 0 0 0 0 0 0 0   
0 0 0 0 0 0 0 0 0 0 0 0 0 1 1 1 2 1 1 1 1 1 1 0 0 0 0 0 0 0   
0 0 0 0 0 0 0 0 0 0 0 0 0 1 2 2 1 1 1 1 1 1 0 0 0 0 0 0 0 0   
0 0 0 0 0 0 0 0 0 0 0 0 0 1 1 1 1 1 1 1 1 0 0 0 0 0 0 0 0 0   
0 0 0 0 0 0 0 0 0 0 0 0 0 1 1 1 1 1 1 1 0 0 0 0 0 0 0 0 0 0   
0 0 0 0 0 0 0 0 0 0 0 0 0 1 1 1 1 1 1 1 0 0 0 0 0 0 0 0 0 0   
0 0 0 0 0 0 0 0 0 0 0 0 0 0 1 1 1 1 1 1 0 0 0 0 0 0 0 0 0 0   
0 0 0 0 0 0 0 0 0 0 0 0 0 0 0 1 1 1 1 0 0 0 0 0 0 0 0 0 0 0   
0 0 0 0 0 0 0 0 0 0 0 0 0 0 0 1 1 0 0 0 0 0 0 0 0 0 0 0 0 0   
0 0 0 0 0 0 0 0 0 0 0 0 0 0 0 1 0 0 0 0 0 0 0 0 0 0 0 0 0 0   
0 0 0 0 0 0 0 0 0 0 0 0 0 0 0 0 0 0 0 0 0 0 0 0 0 0 0 0 0 0   
0 0 0 0 0 0 0 0 0 0 0 0 0 0 0 0 0 0 0 0 0 0 0 0 0 0 0 0 0 0   
0 0 0 0 0 0 0 0 0 0 0 0 0 0 0 0 0 0 0 0 0 0 0 0 0 0 0 0 0 0   
0 0 0 0 0 0 0 0 0 0 0 0 0 0 0 0 0 0 0 0 0 0 0 0 0 0 0 0 0 0   
0 0 0 0 0 0 0 0 0 0 0 0 0 0 0 0 0 0 0 0 0 0 0 0 0 0 0 0 0 0   
