0 0 0 0 0 0 2 2
0 1 1 2 2 2 2 0
0 1 5 2 2 2 3 0
0 2 3 3 3 3 3 0
0 3 3 3 3 4 3 4
0 3 4 4 4 4 3 0
0 0 0 3 4 3 3 0
0 0 0 0 2 1 0 0
